                                
    #                  #        
    #             ###########   
  ############    #         #   
    #   #         #       # #   
    #   #     #####       # #   
    #   #     #   #       # #   
        #         #       # #   
   ################       # #   
        #        ########## #   
        #            #    # #   
        #            #    # #   
        #                 # #   
        #                 # #   
        #   #             # #   
        #   #     ####$#### #   
       ######    # #     # ##   
        #   #    #  #    # #    
        ##############    ###   
                               
