 
 ##  ###### ######## ## 
 ###### ### #  #   # ## 
 ########## ##### ##### 
    #  #  # ##### ### # 
 ########## #### #####  
 ###### ######   #  ##  
     $           #      